21 21
111111111111111111111
120000100000000000001
101110101110111011101
101000100010100010001
101010111010101111111
101010000000100000001
101010111110111110111
100010000010000000001
111010111011101111101
100000001000000000001
101111101011101011111
101000100010001000001
101010101110101111101
100010000000100000101
111011111011111010101
100000100000000010001
101111101110111011101
101000001000100000001
101110101011101111101
100000100000000000003
111111111111111111111