21 21
111111111111111111111
120000101000100000001
101110101110101110111
100010000010100010001
101010111110111011111
101010100010100000001
101010111010111110111
101010100010000000101
111110111011101111101
100010101010000010001
111010101011101011101
100010100010001000001
101010111011101111101
101010000000100000101
111010111011111011101
100000100000000010001
101111101110111011111
101000101000100010101
101011101111101110101
100000100010000000003
111111111111111111111